"","Jobtitle","Female.Avg.Hrly.Rate","No..Female.Empl","Average.of.Female.MONTHS.LONGEVITY.IN.CURRENT.CLASSIFICATION","Male.Avg.Hrly.Rate","No..Male.Empl","Average.of.Male.MONTHS.LONGEVITY.IN.CURRENT.CLASSIFICATION","Total.Avg.Hrly.Rate","Total.No..Empl","Total.Average.of.MONTHS.LONGEVITY.IN.CURRENT.CLASSIFICATION","Ratio.of.women.hourly.rate.to.men.hourly.rate","Notes"
"1","Accountant",30.58,23,89,30.28,7,86,60.86,30,175,1.01,""
"2","Accountant,Prin",38.75,23,60,37.64,7,7,76.39,30,67,1.03,""
"3","Accountant,Sr",34.48,23,61,33.89,6,44,68.37,29,105,1.02,""
"4","Act Exec",43.1,4,146,42.02,7,106,85.12,11,252,1.03,""
"5","Actg Tech I",22.56,1,156,49.49,20,109,72.05,21,265,0.46,"no men in title"
"6","Actg Tech I-BU",22.56,10,82,22.56,2,36,45.12,12,118,1,""
"7","Actg Tech II",23.98,7,113,24.35,1,75,48.33,8,188,0.98,""
"8","Actg Tech II-BU",24.19,74,103,24.21,18,134,48.4,92,237,1,""
"9","Actg Tech III",26.64,7,52,49.49,20,109,76.13,27,161,0.54,"no men in title"
"10","Actg Tech III-BU",26.69,32,90,26.18,5,51,52.87,37,141,1.02,""
"11","Actg Tech II-MC",24.35,2,200,49.49,20,109,73.84,22,309,0.49,"no men in title"
"12","Actg Tech Supv-BU",28.84,4,59,49.49,20,109,78.33,24,168,0.58,"no men in title"
"13","Admin Spec I",22.35,15,129,21.76,2,46,44.11,17,175,1.03,""
"14","Admin Spec I-BU",22.43,78,121,22.43,12,91,44.86,90,212,1,""
"15","Admin Spec II",24.32,28,126,23.9,4,42,48.22,32,168,1.02,""
"16","Admin Spec II-BU",24.25,140,92,24.11,18,76,48.36,158,168,1.01,""
"17","Admin Spec III",26.1,12,78,26.26,2,94,52.36,14,172,0.99,""
"18","Admin Spec III-BU",25.94,30,65,25.93,3,54,51.87,33,119,1,""
"19","Admin Spec III-MC",26.26,1,72,49.49,20,109,75.75,21,181,0.53,"no men in title"
"20","Admin Spec II-MC",24.35,28,129,24.35,2,129,48.7,30,258,1,""
"21","Admin Spec I-MC",22.56,16,145,22.56,3,123,45.12,19,268,1,""
"22","Admin Staff Anlyst",35.59,40,77,35,3,49,70.59,43,126,1.02,""
"23","Admin Staff Asst",30.86,54,66,30.48,8,72,61.34,62,138,1.01,""
"24","Admin Support Asst",20.61,1,77,49.49,20,109,70.1,21,186,0.42,"no men in title"
"25","Admin Support Asst-BU",20.3,10,84,20.61,2,83,40.91,12,167,0.98,""
"26","Admin Support Asst-MC",49.65,16,102,20.61,2,220,70.26,18,322,2.41,"no women in title"
"27","Admin Support Supv-BU",27.58,10,74,27.78,2,141,55.36,12,215,0.99,""
"28","Admin Support Supv-MC",27.78,4,119,27.78,1,158,55.56,5,277,1,""
"29","Administrator-Law",48.11,1,28,49.49,20,109,97.6,21,137,0.97,"no men in title"
"30","Adms Employee",17.11,5,115,17.11,8,102,34.22,13,217,1,""
"31","Adms Personnel Dispatcher",49.65,16,102,24.1,1,161,73.75,17,263,2.06,"no women in title"
"32","Animal Contrl Ofcr I",24.32,1,55,24.08,4,56,48.4,5,111,1.01,""
"33","Animal Contrl Ofcr II",26.53,3,129,26.53,6,142,53.06,9,271,1,""
"34","Animal Contrl Ofcr Supv",30.72,2,54,49.49,20,109,80.21,22,163,0.62,"no men in title"
"35","Appraiser,Sr",49.65,16,102,43.91,1,54,93.56,17,156,1.13,"no women in title"
"36","Apprenticeship Coord",33.69,2,116,49.49,20,109,83.18,22,225,0.68,"no men in title"
"37","Aquarium Biologist 1",23.88,2,53,23.88,1,76,47.76,3,129,1,""
"38","Aquarium Biologist 2",26.26,5,81,26.26,3,71,52.52,8,152,1,""
"39","Aquarium Biologist 3",49.65,16,102,31.16,3,83,80.81,19,185,1.59,"no women in title"
"40","Aquarium Laboratory Spec",26.26,1,124,49.49,20,109,75.75,21,233,0.53,"no men in title"
"41","Aquarium Systs Op,Chief",49.65,16,102,37.7,1,268,87.35,17,370,1.32,"no women in title"
"42","Aquatic Cntr Coord",32.52,7,108,32.52,2,223,65.04,9,331,1,""
"43","Aquatic Cntr Coord,Asst",28.75,4,93,29.17,3,56,57.92,7,149,0.99,""
"44","Arboriculturist",33.09,1,67,32.9,7,81,65.99,8,148,1.01,""
"45","Arborist",49.65,16,102,44.74,2,164,94.39,18,266,1.11,"no women in title"
"46","Architect,Sr",49.65,16,102,44.74,1,49,94.39,17,151,1.11,"no women in title"
"47","Arts Conserv Tech",27.78,1,65,27.78,1,65,55.56,2,130,1,""
"48","Arts Prgm Spec",32.35,5,56,49.49,20,109,81.84,25,165,0.65,"no men in title"
"49","Arts Prgm Spec,Sr",36.37,4,77,36.3,1,18,72.67,5,95,1,""
"50","Asphalt Raker",49.65,16,102,26.94,4,43,76.59,20,145,1.84,"no women in title"
"51","Asphalt Raker,Sr",49.65,16,102,28.23,7,68,77.88,23,170,1.76,"no women in title"
"52","Asst To The Supt",49.65,16,102,46.41,1,2,96.06,17,104,1.07,"no women in title"
"53","Auto Body Wkr/Pntr",49.65,16,102,29.79,2,123,79.44,18,225,1.67,"no women in title"
"54","Auto Engr",49.65,16,102,39.2,2,110,88.85,18,212,1.27,"no women in title"
"55","Auto Engr,Sr",49.65,16,102,40.74,4,28,90.39,20,130,1.22,"no women in title"
"56","Auto Equip Pntr",49.65,16,102,29.79,1,183,79.44,17,285,1.67,"no women in title"
"57","Auto Maint CC",49.65,16,102,36.28,4,63,85.93,20,165,1.37,"no women in title"
"58","Auto Mechanic",31.02,1,138,31.02,48,108,62.04,49,246,1,""
"59","Auto Mechanic Aprn",27.27,1,46,27.27,2,45,54.54,3,91,1,""
"60","Auto Mechanic,Sr",32.6,1,28,32.6,13,91,65.2,14,119,1,""
"61","Auto Sheet Metal Wkr",49.65,16,102,29.79,2,181,79.44,18,283,1.67,"no women in title"
"62","Bailiff",25.77,7,137,24.77,1,25,50.54,8,162,1.04,""
"63","Bailiff,Chief",29.41,1,79,49.49,20,109,78.9,21,188,0.59,"no men in title"
"64","Benefits Asst",26.26,2,203,49.49,20,109,75.75,22,312,0.53,"no men in title"
"65","Bldg Inspector,Journey",49.65,16,102,38.45,2,40,88.1,18,142,1.29,"no women in title"
"66","Bldg Inspector,Sr(Expert)",49.65,16,102,40.74,10,79,90.39,26,181,1.22,"no women in title"
"67","Bldg Inspector,Strucl",49.65,16,102,42.25,2,67,91.9,18,169,1.18,"no women in title"
"68","Bldg Operating Engr",49.65,16,102,31.16,3,138,80.81,19,240,1.59,"no women in title"
"69","Bldg Plans Examiner",36.45,2,4,35.38,4,20,71.83,6,24,1.03,""
"70","Bldg Plans Examiner,Sr",42.25,2,47,49.49,20,109,91.74,22,156,0.85,"no men in title"
"71","Bldg/Facilities Opns Supv-BU",49.65,16,102,30.58,2,41,80.23,18,143,1.62,"no women in title"
"72","Bridge Carpentry&Maint Lead",49.65,16,102,30.28,3,105,79.93,19,207,1.64,"no women in title"
"73","Bridge Elecl CC",49.65,16,102,38.1,1,19,87.75,17,121,1.3,"no women in title"
"74","Bridge Elecl Maint Supv",49.65,16,102,41.07,1,64,90.72,17,166,1.21,"no women in title"
"75","Bridge Maint General Supv",49.65,16,102,37.34,1,55,86.99,17,157,1.33,"no women in title"
"76","Bridge Maint Mech Hlpr",49.65,16,102,23.79,3,114,73.44,19,216,2.09,"no women in title"
"77","Bridge Maint Mechanic",49.65,16,102,33.37,3,98,83.02,19,200,1.49,"no women in title"
"78","Bridge Maint Mechanic CC",49.65,16,102,35.43,1,4,85.08,17,106,1.4,"no women in title"
"79","Bridge Op",27.34,1,385,27.26,12,166,54.6,13,551,1,""
"80","Bridge Op,Sr",28.85,2,68,28.85,2,126,57.7,4,194,1,""
"81","Bridge Opns CC",49.65,16,102,34.02,1,71,83.67,17,173,1.46,"no women in title"
"82","Bridge Opns General Supv",37.39,1,76,49.49,20,109,86.88,21,185,0.76,"no men in title"
"83","Buyer,Sr",39.96,3,51,38.86,4,73,78.82,7,124,1.03,""
"84","Camp Svc Aide",17.99,2,206,49.49,20,109,67.48,22,315,0.36,"no men in title"
"85","Camp Svc Aide,Sr",19.8,1,203,49.49,20,109,69.29,21,312,0.4,"no men in title"
"86","Capital Prjts Coord",41.56,3,48,41.04,9,70,82.6,12,118,1.01,""
"87","Capital Prjts Coord Supv",42.51,1,0,49.33,1,3,91.84,2,3,0.86,""
"88","Capital Prjts Coord Supv-BU",49.33,1,15,47.62,1,13,96.95,2,28,1.04,""
"89","Capital Prjts Coord,Asst",38.5,3,47,49.49,20,109,87.99,23,156,0.78,"no men in title"
"90","Capital Prjts Coord,Chief",49.33,1,67,49.49,20,109,98.82,21,176,1,"no men in title"
"91","Capital Prjts Coord,Sr",46.98,12,74,47.12,35,72,94.1,47,146,1,""
"92","Carpenter",30.28,4,276,30.28,18,138,60.56,22,414,1,""
"93","Carpenter CC",49.65,16,102,34.08,4,120,83.73,20,222,1.46,"no women in title"
"94","Carpenter,Sr",31.57,1,146,31.57,3,103,63.14,4,249,1,""
"95","Cashier",16.62,12,76,16.6,5,116,33.22,17,192,1,""
"96","Cashier,Sr",19.38,3,84,18.74,1,52,38.12,4,136,1.03,""
"97","Cblspl Aprn",49.65,16,102,31.68,4,14,81.33,20,116,1.57,"no women in title"
"98","Cblspl CC-Asg C Coord",49.65,16,102,46.28,2,81,95.93,18,183,1.07,"no women in title"
"99","Cblspl CC-Asg Locator",46.28,1,19,49.49,20,109,95.77,21,128,0.94,"no men in title"
"100","Cblspl CC-Net Area",46.28,3,37,46.28,16,101,92.56,19,138,1,""
"101","Cblspl-Asg Locator",41.14,1,18,41.14,2,36,82.28,3,54,1,""
"102","Cblspl-Jrnywkr In Chg",49.65,16,102,43.33,3,32,92.98,19,134,1.15,"no women in title"
"103","Cblspl-Net Area",41.14,5,78,41.14,37,43,82.28,42,121,1,""
"104","Cement Finisher",49.65,16,102,28.24,5,184,77.89,21,286,1.76,"no women in title"
"105","Cement Finisher,Sr",49.65,16,102,29.88,5,95,79.53,21,197,1.66,"no women in title"
"106","Cement Finisher-Parks Facils",49.65,16,102,30.28,2,105,79.93,18,207,1.64,"no women in title"
"107","City Archivist,Asst",38.48,3,98,49.49,20,109,87.97,23,207,0.78,"no men in title"
"108","City Attorney",49.65,16,102,73.26,1,40,122.91,17,142,0.68,"no women in title"
"109","City Attorney,Asst",49.2,36,63,55.11,28,73,104.31,64,136,0.89,""
"110","City Attorney,Asst-BU",36.72,17,25,41.8,10,26,78.52,27,51,0.88,""
"111","City Light Supt",49.65,16,102,117.32,1,111,166.97,17,213,0.42,"no women in title"
"112","City Records Mgmt Anlyst",36.3,1,42,32.39,1,8,68.69,2,50,1.12,""
"113","Civil Engr Supv",54.51,13,50,54.16,31,77,108.67,44,127,1.01,""
"114","Civil Engr,Assoc",39.7,14,95,39.91,28,82,79.61,42,177,0.99,""
"115","Civil Engr,Asst I",49.65,16,102,29.69,3,15,79.34,19,117,1.67,"no women in title"
"116","Civil Engr,Asst II",49.65,16,102,32.36,4,13,82.01,20,115,1.53,"no women in title"
"117","Civil Engr,Asst III",49.65,16,102,37.38,2,76,87.03,18,178,1.33,"no women in title"
"118","Civil Engr,Sr",49.61,31,76,50.2,60,88,99.81,91,164,0.99,""
"119","Civil Engrng Spec Supv",45.51,6,56,45.51,11,50,91.02,17,106,1,""
"120","Civil Engrng Spec,Assoc",38.06,28,95,38.06,56,81,76.12,84,176,1,""
"121","Civil Engrng Spec,Asst I",29.41,2,48,28.33,5,10,57.74,7,58,1.04,""
"122","Civil Engrng Spec,Asst II",29.05,1,8,31.34,7,60,60.39,8,68,0.93,""
"123","Civil Engrng Spec,Asst III",34.91,10,57,34.73,16,58,69.64,26,115,1.01,""
"124","Civil Engrng Spec,Sr",43.08,20,63,42.85,53,74,85.93,73,137,1.01,""
"125","Civil Rights Anlyst",31.19,4,21,33.56,1,78,64.75,5,99,0.93,""
"126","Civil Rights Anlyst,Sr",36.3,2,51,36.33,1,49,72.63,3,100,1,""
"127","Civil Svc Commissioner",5.53,1,4,5.53,5,62,11.06,6,66,1,""
"128","Claims Adjuster I",31.76,1,153,49.49,20,109,81.25,21,262,0.64,"no men in title"
"129","Claims Adjuster-FAS",36.3,1,12,40.74,2,68,77.04,3,80,0.89,""
"130","Code Compliance Anlyst",37.7,2,40,49.49,20,109,87.19,22,149,0.76,"no men in title"
"131","Code Compliance Coord",43.1,1,67,49.49,20,109,92.59,21,176,0.87,"no men in title"
"132","Code Dev Anlyst,Sr",40.74,1,31,49.49,20,109,90.23,21,140,0.82,"no men in title"
"133","Com Dev Spec",35.21,6,60,36.3,2,91,71.51,8,151,0.97,""
"134","Com Dev Spec,Sr",42.47,5,75,43.1,3,94,85.57,8,169,0.99,""
"135","Com Garden Coord",32.39,5,98,32.39,1,143,64.78,6,241,1,""
"136","Commercial Veh Enf Ofcr",49.65,16,102,30.24,1,335,79.89,17,437,1.64,"no women in title"
"137","Comms Elctn CC",49.65,16,102,47.15,1,160,96.8,17,262,1.05,"no women in title"
"138","Comms Elctn II",49.65,16,102,41.91,14,207,91.56,30,309,1.18,"no women in title"
"139","Comms Elctn Jnywrk-In Chg-Skt",49.65,16,102,44.15,1,49,93.8,17,151,1.12,"no women in title"
"140","Complaint Investigator",31.76,3,75,31.76,2,94,63.52,5,169,1,""
"141","Constr&Maint Equip Op",30.49,1,228,30.49,26,134,60.98,27,362,1,""
"142","Constr&Maint Equip Op,Sr",32.01,1,140,32.01,19,62,64.02,20,202,1,""
"143","Constr&Repair CC",49.65,16,102,33.38,3,161,83.03,19,263,1.49,"no women in title"
"144","Contract Anlyst",31.18,3,15,49.49,20,109,80.67,23,124,0.63,"no men in title"
"145","Contract Employee *",45.96,2,38,61.42,1,25,107.38,3,63,0.75,""
"146","Contracts&Concss Asst",49.65,16,102,29.99,1,111,79.64,17,213,1.66,"no women in title"
"147","Contrl Tech",49.65,16,102,33.09,1,6,82.74,17,108,1.5,"no women in title"
"148","Cook",49.65,16,102,25.04,1,33,74.69,17,135,1.98,"no women in title"
"149","Council Clerk",31.76,2,39,49.49,20,109,81.25,22,148,0.64,"no men in title"
"150","Councilmember",57.07,3,80,56.88,6,108,113.95,9,188,1,""
"151","Counslr",29.4,80,67,30.39,14,105,59.79,94,172,0.97,""
"152","Court Cashier",24.66,7,96,24.55,5,135,49.21,12,231,1,""
"153","Court Cashier Supv",27.04,1,107,27.04,1,178,54.08,2,285,1,""
"154","Court Clerk",25.04,20,91,25.32,1,98,50.36,21,189,0.99,""
"155","Court Clerk Supv",26.8,3,28,49.49,20,109,76.29,23,137,0.54,"no men in title"
"156","Court Interpreter Coord",39.2,1,70,49.49,20,109,88.69,21,179,0.79,"no men in title"
"157","Credit Rep",28.83,3,161,28.58,4,95,57.41,7,256,1.01,""
"158","Credit Rep,Sr",49.65,16,102,31.41,2,124,81.06,18,226,1.58,"no women in title"
"159","Credit&Colls Supv-BU",36.3,1,180,36.3,1,89,72.6,2,269,1,""
"160","Crime Prev Coord",33.69,1,268,33.69,3,250,67.38,4,518,1,""
"161","Cust Svc Rep",24.21,34,69,24.32,8,67,48.53,42,136,1,""
"162","Cust Svc Rep Supv",30.35,1,72,30.35,1,98,60.7,2,170,1,""
"163","Cust Svc Rep,Sr",26.18,5,41,49.49,20,109,75.67,25,150,0.53,"no men in title"
"164","Delivery Wkr",21.36,2,55,21.36,3,90,42.72,5,145,1,""
"165","Dev Fin Spec I",33.09,2,130,49.49,20,109,82.58,22,239,0.67,"no men in title"
"166","Dev Fin Spec,Sr",37.74,2,4,49.49,20,109,87.23,22,113,0.76,"no men in title"
"167","Dining Room Attendant",15.66,2,56,14.8,1,9,30.46,3,65,1.06,""
"168","Dining Room Attendant,Sr",49.65,16,102,18.11,1,97,67.76,17,199,2.74,"no women in title"
"169","Disposal CC I",33.93,2,74,33.93,2,80,67.86,4,154,1,""
"170","Dispute Resolution Mediator",38.48,1,96,49.49,20,109,87.97,21,205,0.78,"no men in title"
"171","Drainage&Wstwtr Coll CC",36.72,2,58,36.72,9,67,73.44,11,125,1,""
"172","Drainage&Wstwtr Coll Lead Wkr",49.65,16,102,30.7,11,101,80.35,27,203,1.62,"no women in title"
"173","Drainage&Wstwtr Coll Wkr",27.56,2,39,27.42,15,87,54.98,17,126,1.01,""
"174","Drainage&Wstwtr Coll Wkr Aprn",23.98,3,11,23.92,10,11,47.9,13,22,1,""
"175","Drainage&Wstwtr Coll Wkr CI",28.09,4,38,28.09,15,60,56.18,19,98,1,""
"176","Drainage&Wstwtr Lead Wkr CII",29.81,2,8,31.31,26,52,61.12,28,60,0.95,""
"177","Drainage&Wstwtr Spec",38.44,1,118,49.49,20,109,87.93,21,227,0.78,"no men in title"
"178","Early Ed Spec",33.89,6,54,34.32,1,59,68.21,7,113,0.99,""
"179","Early Ed Spec,Sr",36.28,2,42,49.49,20,109,85.77,22,151,0.73,"no men in title"
"180","Economist",34.32,1,5,35.66,2,14,69.98,3,19,0.96,""
"181","Economist,Prin",47.26,1,28,47.26,3,56,94.52,4,84,1,""
"182","Economist,Sr",44.28,7,97,43.14,2,44,87.42,9,141,1.03,""
"183","Ed Prgm Asst",22.56,4,75,49.49,20,109,72.05,24,184,0.46,"no men in title"
"184","Ed Prgm Supv",35.57,2,96,49.49,20,109,85.06,22,205,0.72,"no men in title"
"185","Elctn",36.25,2,94,36.08,16,98,72.33,18,192,1,""
"186","Elctn CC",40.13,3,114,49.49,20,109,89.62,23,223,0.81,"no men in title"
"187","Elctn,Sr",49.65,16,102,37.51,1,9,87.16,17,111,1.32,"no women in title"
"188","Elctn-Con",41.14,6,119,41.14,59,75,82.28,65,194,1,""
"189","Elctn-Con Aprn",49.65,16,102,31.84,5,15,81.49,21,117,1.56,"no women in title"
"190","Elctn-Con CC",49.65,16,102,46.28,1,38,95.93,17,140,1.07,"no women in title"
"191","Elctn-Con-(OI)",41.14,4,139,41.14,8,202,82.28,12,341,1,""
"192","Elctn-Con-Wkg CC",46.28,2,24,46.28,11,109,92.56,13,133,1,""
"193","Elec Engrng Des Spec,Asst II",49.65,16,102,34.6,1,40,84.25,17,142,1.43,"no women in title"
"194","Elec Engrng Des Spec,Asst III",49.65,16,102,35.99,2,50,85.64,18,152,1.38,"no women in title"
"195","Elec-Con CC-Asg Crew Coord",49.65,16,102,46.28,1,62,95.93,17,164,1.07,"no women in title"
"196","Elec-Con Core CC",49.65,16,102,46.28,2,42,95.93,18,144,1.07,"no women in title"
"197","Elec-Con(OI)Wkg CC-C Coord",46.28,1,126,46.28,1,18,92.56,2,144,1,""
"198","Elec-Con-Wkg CC-Asg C Coord",49.65,16,102,46.28,3,30,95.93,19,132,1.07,"no women in title"
"199","Elecl Constr&Maint Supv-BU",55.04,3,65,54.85,11,56,109.89,14,121,1,""
"200","Elecl Engr,Assoc",39.36,5,51,39.05,19,44,78.41,24,95,1.01,""
"201","Elecl Engr,Asst I",30.85,2,47,29.95,9,34,60.8,11,81,1.03,""
"202","Elecl Engr,Asst II",49.65,16,102,33.74,6,36,83.39,22,138,1.47,"no women in title"
"203","Elecl Engr,Asst III",49.65,16,102,36.69,4,144,86.34,20,246,1.35,"no women in title"
"204","Elecl Engr,Sr",50.69,1,120,50.69,1,140,101.38,2,260,1,""
"205","Elecl Engrng Spec Supv",44.41,3,51,45.51,2,22,89.92,5,73,0.98,""
"206","Elecl Engrng Spec,Assoc",37.12,7,37,37.52,4,60,74.64,11,97,0.99,""
"207","Elecl Engrng Spec,Asst I",29.05,2,88,27.52,2,9,56.57,4,97,1.06,""
"208","Elecl Engrng Spec,Asst II",30.74,2,10,49.49,20,109,80.23,22,119,0.62,"no men in title"
"209","Elecl Engrng Spec,Asst III",34.64,4,54,49.49,20,109,84.13,24,163,0.7,"no men in title"
"210","Elecl Engrng Spec,Sr",42.85,5,47,43.08,16,48,85.93,21,95,0.99,""
"211","Elecl Hlpr",49.65,16,102,29.11,5,145,78.76,21,247,1.71,"no women in title"
"212","Elecl Hlpr-Bndry",49.65,16,102,29.11,1,272,78.76,17,374,1.71,"no women in title"
"213","Elecl Inspector Supv",49.65,16,102,45.58,2,20,95.23,18,122,1.09,"no women in title"
"214","Elecl Inspector,(J)",38.37,1,9,38.37,2,10,76.74,3,19,1,""
"215","Elecl Inspector,Sr(Expert)",43.06,2,63,43.06,13,115,86.12,15,178,1,""
"216","Elecl Plans Examiner",49.65,16,102,40.42,3,48,90.07,19,150,1.23,"no women in title"
"217","Elecl Pwr Systs Engr",51.93,6,54,51.4,15,41,103.33,21,95,1.01,""
"218","Elecl Pwr Systs Engr,Prin",54.42,4,18,55.22,11,23,109.64,15,41,0.99,""
"219","Elecl PwrSystsEngr,Prin-Mrt",60.11,1,37,58.25,10,36,118.36,11,73,1.03,""
"220","Elecl PwrSystsEngr-Mrt",55.08,1,9,55.08,2,26,110.16,3,35,1,""
"221","Elecl Quality Assurance Spec",49.65,16,102,37.38,1,19,87.03,17,121,1.33,"no women in title"
"222","Elecl Svc Engr",45.25,1,72,44.27,5,80,89.52,6,152,1.02,""
"223","Elecl Svc Rep",31.79,6,81,32.31,7,58,64.1,13,139,0.98,""
"224","Elecl Svc Rep,Sr",35.37,4,64,34.71,13,74,70.08,17,138,1.02,""
"225","Elecl Svc Rep,Supvsng",39.95,3,64,39.95,4,88,79.9,7,152,1,""
"226","Elecl Work Rev CC",49.65,16,102,46.28,4,62,95.93,20,164,1.07,"no women in title"
"227","Electric Util Exec 2",49.65,16,102,77.8,3,21,127.45,19,123,0.64,"no women in title"
"228","Electric Util Exec 3,Dir",86.34,1,64,86.81,6,36,173.15,7,100,0.99,""
"229","Electric Util Exec 3,Ofcr",49.65,16,102,107.39,2,24,157.04,18,126,0.46,"no women in title"
"230","Elevator Inspector(J)",49.65,16,102,37.73,3,29,87.38,19,131,1.32,"no women in title"
"231","Elevator Inspector,Chief",49.65,16,102,43.92,2,27,93.57,18,129,1.13,"no women in title"
"232","Elevator Inspector,Sr(Expert)",40.74,1,72,40.74,6,47,81.48,7,119,1,""
"233","Engrng Aide",24.69,5,61,25.99,6,68,50.68,11,129,0.95,""
"234","Engrng Emerg Laborer",49.65,16,102,28.77,5,73,78.42,21,175,1.73,"no women in title"
"235","Enrgy Mgmt Anlyst",41.39,1,22,41.42,4,36,82.81,5,58,1,""
"236","Enrgy Mgmt Anlyst Supv",49.56,2,86,49.56,2,139,99.12,4,225,1,""
"237","Enrgy Mgmt Anlyst,Asst",35.57,3,28,36.59,5,74,72.16,8,102,0.97,""
"238","Enrgy Mgmt Anlyst,Sr",45.96,4,26,45.96,14,50,91.92,18,76,1,""
"239","Enrgy Plng Anlyst",33.69,1,5,33.67,2,10,67.36,3,15,1,""
"240","Enrgy Plng Supv-BU",49.65,16,102,49.56,2,110,99.21,18,212,1,"no women in title"
"241","Enrgy Res&Eval Anlyst",49.65,16,102,39.96,1,260,89.61,17,362,1.24,"no women in title"
"242","Envrnmtl Anlyst,Assoc",35.05,2,42,35.93,3,55,70.98,5,97,0.98,""
"243","Envrnmtl Anlyst,Sr",42.85,19,109,42.63,13,64,85.48,32,173,1.01,""
"244","Envrnmtl Fld Spec",31.74,4,110,31.74,2,92,63.48,6,202,1,""
"245","Envrnmtl Fld Spec,Sr",49.65,16,102,34.27,2,72,83.92,18,174,1.45,"no women in title"
"246","Equal Emplmnt Coord",37.75,2,27,49.49,20,109,87.24,22,136,0.76,"no men in title"
"247","Equip Maint CC",49.65,16,102,34.92,2,162,84.57,18,264,1.42,"no women in title"
"248","Equip Svcr",49.65,16,102,24.28,13,115,73.93,29,217,2.04,"no women in title"
"249","Equip&Facilities Coord",49.65,16,102,34.04,7,84,83.69,23,186,1.46,"no women in title"
"250","Equip&Facils Coord,Sr",49.65,16,102,37.7,1,175,87.35,17,277,1.32,"no women in title"
"251","Events Booking Rep",29.99,1,24,27.78,1,10,57.77,2,34,1.08,""
"252","Events Booking Rep,Sr",36.3,1,110,31.16,1,3,67.46,2,113,1.16,""
"253","Events Svc Rep",32.39,3,93,49.49,20,109,81.88,23,202,0.65,"no men in title"
"254","Events Svc Rep,Sr",36.3,3,116,36.3,2,85,72.6,5,201,1,""
"255","Evidence Warehouser",23.8,3,40,25.03,2,142,48.83,5,182,0.95,""
"256","Evidence Warehouser,Sr",27.54,2,106,27.54,4,52,55.08,6,158,1,""
"257","Exec Asst",41.56,14,66,43.1,2,67,84.66,16,133,0.96,""
"258","Exec Asst,Sr",44.03,9,67,43.14,2,48,87.17,11,115,1.02,""
"259","Exec Manager-City Auditor",49.65,16,102,65.26,1,41,114.91,17,143,0.76,"no women in title"
"260","Exec Manager-Legislative",63.87,1,34,64.7,1,85,128.57,2,119,0.99,""
"261","Executive1",57.91,4,34,56.59,6,41,114.5,10,75,1.02,""
"262","Executive2",63.18,45,59,63.94,44,58,127.12,89,117,0.99,""
"263","Executive3",73.05,15,68,70.83,18,33,143.88,33,101,1.03,""
"264","Executive4",72.13,2,18,87.78,15,56,159.91,17,74,0.82,""
"265","Exhibits Tech",49.65,16,102,28.03,1,53,77.68,17,155,1.77,"no women in title"
"266","Facilities Lead Wkr",26.5,1,119,26.5,5,81,53,6,200,1,""
"267","Facilities Maint Wkr",26.5,1,103,26.34,6,134,52.84,7,237,1.01,""
"268","Facilities Support Coord",49.65,16,102,39.2,1,54,88.85,17,156,1.27,"no women in title"
"269","Facility Maint Supv,Asst",49.65,16,102,42.34,3,71,91.99,19,173,1.17,"no women in title"
"270","Facility Techl Supv",49.65,16,102,35.62,2,16,85.27,18,118,1.39,"no women in title"
"271","Facility Techl Supv-BU",49.65,16,102,36.3,1,17,85.95,17,119,1.37,"no women in title"
"272","Fair Hearing Coord",49.65,16,102,33.6,1,55,83.25,17,157,1.48,"no women in title"
"273","Fin Anlyst",33.98,10,37,49.49,20,109,83.47,30,146,0.69,"no men in title"
"274","Fin Anlyst Supv",49.65,16,102,41.55,1,0,91.2,17,102,1.19,"no women in title"
"275","Fin Anlyst,Asst",27.48,3,101,28.84,1,12,56.32,4,113,0.95,""
"276","Fin Anlyst,Sr",39.66,20,75,39.09,17,42,78.75,37,117,1.01,""
"277","Fire Battalion Chief-80 Hrs",49.65,16,102,65.85,1,10,115.5,17,112,0.75,"no women in title"
"278","Fire Battalion Chief-91.4 Hrs",59.25,1,30,57.8,22,73,117.05,23,103,1.03,""
"279","Fire Capt-80 Hrs",49.65,16,102,56.09,1,4,105.74,17,106,0.89,"no women in title"
"280","Fire Capt-91.40 Hrs",48.11,4,20,47.77,32,31,95.88,36,51,1.01,""
"281","Fire Capt-Admin-80 Hrs",57.39,1,26,57.39,2,13,114.78,3,39,1,""
"282","Fire Capt-Dispatcher-80 Hrs",49.65,16,102,58.14,1,10,107.79,17,112,0.85,"no women in title"
"283","Fire Capt-HM-91.40 Hrs",49.65,16,102,49.2,3,34,98.85,19,136,1.01,"no women in title"
"284","Fire Capt-MU-91.40 Hrs",49.65,16,102,50.07,2,52,99.72,18,154,0.99,"no women in title"
"285","Fire Capt-ParamedTechSrEMS-80",49.65,16,102,64.29,1,39,113.94,17,141,0.77,"no women in title"
"286","Fire Capt-Prev Inspector I",49.65,16,102,57.64,3,18,107.29,19,120,0.86,"no women in title"
"287","Fire Capt-Trng Div-80 Hrs",49.65,16,102,56.77,3,13,106.42,19,115,0.87,"no women in title"
"288","Fire Capt-TRT-91.40 Hrs",49.65,16,102,49.42,1,52,99.07,17,154,1,"no women in title"
"289","Fire Chief,Dep-80 Hrs",49.65,16,102,75.26,5,29,124.91,21,131,0.66,"no women in title"
"290","Fire Chief,Dep-91.4 Hrs",49.65,16,102,66.42,4,14,116.07,20,116,0.75,"no women in title"
"291","Fire Equip Tech",27.25,1,21,27.25,2,134,54.5,3,155,1,""
"292","Fire Lieut-80 Hrs",49.65,16,102,48.48,5,7,98.13,21,109,1.02,"no women in title"
"293","Fire Lieut-91.40 Hrs",42.42,11,42,41.87,93,37,84.29,104,79,1.01,""
"294","Fire Lieut-Admin-80 Hrs",49.65,16,102,49.3,2,10,98.95,18,112,1.01,"no women in title"
"295","Fire Lieut-Dispatcher-84 Hrs",49.65,16,102,49.62,4,163,99.27,20,265,1,"no women in title"
"296","Fire Lieut-HM-91.40 Hrs",43.81,1,3,43.85,8,46,87.66,9,49,1,""
"297","Fire Lieut-MU-91.40 Hrs",49.65,16,102,43.48,9,35,93.13,25,137,1.14,"no women in title"
"298","Fire Lieut-ParamedTechSr-84",49.65,16,102,52.63,4,80,102.28,20,182,0.94,"no women in title"
"299","Fire Lieut-ParamedTechSrAMR-80",49.65,16,102,57.12,1,21,106.77,17,123,0.87,"no women in title"
"300","Fire Lieut-ParamedTechSrEMS-80",49.65,16,102,56.38,1,6,106.03,17,108,0.88,"no women in title"
"301","Fire Lieut-Prev Inspector I",52.09,2,196,51.4,7,113,103.49,9,309,1.01,""
"302","Fire Lieut-Trng Div-80 Hrs",49.65,16,102,49.42,6,10,99.07,22,112,1,"no women in title"
"303","Fire Lieut-TRT-91.40 Hrs",49.65,16,102,43.81,3,52,93.46,19,154,1.13,"no women in title"
"304","Fire Protection Engr",49.65,16,102,40.06,4,93,89.71,20,195,1.24,"no women in title"
"305","Fire Protection Engr,Sr",49.65,16,102,47.26,2,111,96.91,18,213,1.05,"no women in title"
"306","Fire Svcs Spec",49.65,16,102,27.25,1,266,76.9,17,368,1.82,"no women in title"
"307","Fireboat Engr-91.40 Hrs",49.65,16,102,48.44,4,52,98.09,20,154,1.02,"no women in title"
"308","Fireboat Pilot-91.40 Hrs",49.65,16,102,47.49,4,29,97.14,20,131,1.05,"no women in title"
"309","Fireftr-80 Hrs",49.65,16,102,40.93,2,12,90.58,18,114,1.21,"no women in title"
"310","Fireftr-91.40 Hrs",35.68,17,35,34.36,307,39,70.04,324,74,1.04,""
"311","Fireftr-Ap Drvr-80 Hrs",49.65,16,102,45.58,2,12,95.23,18,114,1.09,"no women in title"
"312","Fireftr-AP Drvr-91.40 Hrs",38.11,10,48,38.41,158,37,76.52,168,85,0.99,""
"313","Fireftr-Dispatcher-84 Hrs",43.58,14,139,43.16,9,110,86.74,23,249,1.01,""
"314","Fireftr-FIU Prev Insp I-84 Hrs",49.65,16,102,43.72,7,99,93.37,23,201,1.14,"no women in title"
"315","Fireftr-HM Ap Drvr-80 Hrs",49.65,16,102,45.58,1,5,95.23,17,107,1.09,"no women in title"
"316","Fireftr-HM Ap Drvr-91.40 Hrs",49.65,16,102,41,16,41,90.65,32,143,1.21,"no women in title"
"317","Fireftr-HM-80 Hrs",49.65,16,102,41.86,1,7,91.51,17,109,1.19,"no women in title"
"318","Fireftr-HM-91.40 Hrs",37.46,4,36,36.85,41,34,74.31,45,70,1.02,""
"319","Fireftr-MU Ap Drvr-91.40 Hrs",49.65,16,102,39.81,7,38,89.46,23,140,1.25,"no women in title"
"320","Fireftr-MU-91.40 Hrs",49.65,16,102,37.76,28,34,87.41,44,136,1.31,"no women in title"
"321","Fireftr-ParamedTech-91.40 Hrs",40.71,2,27,40.26,15,23,80.97,17,50,1.01,""
"322","Fireftr-ParamedTechSr-91.40",42.69,14,45,42.48,35,44,85.17,49,89,1,""
"323","Fireftr-Prev Insp I",45.89,3,66,46.06,10,112,91.95,13,178,1,""
"324","Fireftr-Staff10-91.40 Hrs",49.65,16,102,39.98,4,35,89.63,20,137,1.24,"no women in title"
"325","Fireftr-TRT Ap Drvr-91.40 Hrs",41.21,1,52,40.77,3,40,81.98,4,92,1.01,""
"326","Fireftr-TRT-91.40 Hrs",49.65,16,102,37.56,16,37,87.21,32,139,1.32,"no women in title"
"327","Fireftr-TRT-R1 Ap Drvr-91.40",49.65,16,102,40.39,4,30,90.04,20,132,1.23,"no women in title"
"328","Fleet Mgmt Anlyst",49.65,16,102,36.3,1,364,85.95,17,466,1.37,"no women in title"
"329","Fleet Mgmt Coord",49.65,16,102,34.94,1,16,84.59,17,118,1.42,"no women in title"
"330","Forest Maint CC",49.65,16,102,33.93,1,66,83.58,17,168,1.46,"no women in title"
"331","Forest Maint Wkr",49.65,16,102,27.37,5,74,77.02,21,176,1.81,"no women in title"
"332","Forest Maint Wkr,Sr",29.41,1,121,29.41,1,56,58.82,2,177,1,""
"333","Gardener",24.33,21,122,24,21,53,48.33,42,175,1.01,""
"334","Gardener,Asst",49.65,16,102,21.77,1,22,71.42,17,124,2.28,"no women in title"
"335","Gardener,Sr",27.14,9,101,27.18,15,111,54.32,24,212,1,""
"336","Generation Supv",49.65,16,102,54.61,1,200,104.26,17,302,0.91,"no women in title"
"337","Generation Supv-BU",49.65,16,102,54.61,2,229,104.26,18,331,0.91,"no women in title"
"338","Golf Course Groundskeeper I",49.65,16,102,13.75,3,48,63.4,19,150,3.61,"no women in title"
"339","Golf Course Groundskeeper II",18.12,2,19,18.12,4,28,36.24,6,47,1,""
"340","Golf Course Maint Supv",49.65,16,102,33.78,4,97,83.43,20,199,1.47,"no women in title"
"341","Golf Course Tech",49.65,16,102,23.71,10,115,73.36,26,217,2.09,"no women in title"
"342","Grants&Contracts Spec",30.55,1,244,49.49,20,109,80.04,21,353,0.62,"no men in title"
"343","Grants&Contracts Spec,Sr",32.43,26,104,32.41,7,134,64.84,33,238,1,""
"344","Graphic Arts Designer",29.61,3,107,29.99,1,73,59.6,4,180,0.99,""
"345","Grounds Equip Mechanic",49.65,16,102,27.62,6,87,77.27,22,189,1.8,"no women in title"
"346","Grounds Equip Mechanic,Sr",49.65,16,102,29.99,3,112,79.64,19,214,1.66,"no women in title"
"347","Grounds Maint CC",49.65,16,102,33.38,2,38,83.03,18,140,1.49,"no women in title"
"348","Grounds Maint Lead Wkr",26.5,5,114,26.5,10,85,53,15,199,1,""
"349","Hearing Examiner",72.07,1,116,49.49,20,109,121.56,21,225,1.46,"no men in title"
"350","Hearing Examiner,Dep",59.89,1,220,49.49,20,109,109.38,21,329,1.21,"no men in title"
"351","Housing Ordinance Spec",31.16,1,61,49.49,20,109,80.65,21,170,0.63,"no men in title"
"352","Housing Ordinance Supv",49.65,16,102,36.3,1,141,85.95,17,243,1.37,"no women in title"
"353","Housing/Zoning Inspector",34.32,5,94,33.68,4,64,68,9,158,1.02,""
"354","Housing/Zoning Inspector Supv",49.65,16,102,39.96,1,113,89.61,17,215,1.24,"no women in title"
"355","Housing/Zoning Inspector,Sr",36.3,1,80,36.3,1,11,72.6,2,91,1,""
"356","Housing/Zoning Tech",26.26,2,50,49.49,20,109,75.75,22,159,0.53,"no men in title"
"357","Housing/Zoning Tech,Sr",49.65,16,102,28.84,1,86,78.49,17,188,1.72,"no women in title"
"358","HRIS Spec",33.69,2,83,33.69,1,104,67.38,3,187,1,""
"359","Human Svcs Coord",29.99,5,152,49.49,20,109,79.48,25,261,0.61,"no men in title"
"360","Human Svcs Prgm Supv",35.96,4,74,49.49,20,109,85.45,24,183,0.73,"no men in title"
"361","Human Svcs Prgm Supv,Sr",37.25,5,50,37.82,4,74,75.07,9,124,0.98,""
"362","HVAC Tech",49.65,16,102,32.62,16,57,82.27,32,159,1.52,"no women in title"
"363","Hydro Maint Wkr I-Gen",49.65,16,102,24.65,6,46,74.3,22,148,2.01,"no women in title"
"364","Hydro Maint Wkr II-Gen",49.65,16,102,26,1,25,75.65,17,127,1.91,"no women in title"
"365","Hydroelec Maint Mach",49.65,16,102,38.36,11,104,88.01,27,206,1.29,"no women in title"
"366","Hydroelec Maint Mach CC",49.65,16,102,44.51,3,15,94.16,19,117,1.12,"no women in title"
"367","Hydroelec Op II",41.14,2,225,41.14,11,125,82.28,13,350,1,""
"368","Identification Data Spec",24.22,6,55,24.36,2,64,48.58,8,119,0.99,""
"369","Identification Tech",31.57,7,120,31.74,1,125,63.31,8,245,0.99,""
"370","Indus Hygienist,Certified",49.65,16,102,44.74,1,5,94.39,17,107,1.11,"no women in title"
"371","Info Technol Prgmmer Anlyst",36.3,1,108,36.3,2,126,72.6,3,234,1,""
"372","Info Technol Prof A,Exempt",56.11,29,79,55.27,60,85,111.38,89,164,1.02,""
"373","Info Technol Prof B",47.11,19,101,47.09,53,96,94.2,72,197,1,""
"374","Info Technol Prof B,Exempt",49.65,16,102,49.58,2,124,99.23,18,226,1,"no women in title"
"375","Info Technol Prof B-BU",48.55,66,88,48.12,119,83,96.67,185,171,1.01,""
"376","Info Technol Prof C",42.03,6,90,40.03,28,90,82.06,34,180,1.05,""
"377","Info Technol Prof C-BU",41.29,13,69,40.35,48,60,81.64,61,129,1.02,""
"378","Info Technol Spec",31.16,6,51,31.76,1,72,62.92,7,123,0.98,""
"379","Info Technol Systs Anlyst",37.93,15,113,37.82,34,98,75.75,49,211,1,""
"380","Info Technol Techl Support",25.77,2,85,49.49,20,109,75.26,22,194,0.52,"no men in title"
"381","Inspection Support Anlyst",35,2,64,49.49,20,109,84.49,22,173,0.71,"no men in title"
"382","Installation Maint Wkr",25.54,2,18,25.33,18,83,50.87,20,101,1.01,""
"383","Investments/Debt Dir",49.65,16,102,78.83,1,61,128.48,17,163,0.63,"no women in title"
"384","Investments/Debt Dir,Asst",59.03,1,61,49.49,20,109,108.52,21,170,1.19,"no men in title"
"385","IT Prgmmer Anlyst-Spec",49.65,16,102,36.68,1,160,86.33,17,262,1.35,"no women in title"
"386","Janitor,Lead-FAS/CL",20.96,1,68,20.96,3,59,41.92,4,127,1,""
"387","Janitor,Lead-SC/Parks/SPU",20.96,1,192,19.38,1,1,40.34,2,193,1.08,""
"388","Janitor-FAS/CL",19.38,6,132,19.38,17,136,38.76,23,268,1,""
"389","Janitorial CC-FAS",24.73,1,49,49.49,20,109,74.22,21,158,0.5,"no men in title"
"390","Janitor-SC/Parks/SPU",19.38,8,88,19.38,5,104,38.76,13,192,1,""
"391","Jrnywkr Asg Streetlighting",49.65,16,102,42.37,2,134,92.02,18,236,1.17,"no women in title"
"392","Jrnywkr In Chg",44.63,1,11,44.63,10,90,89.26,11,101,1,""
"393","Labor Relations Coord",48.45,3,54,49.05,1,49,97.5,4,103,0.99,""
"394","Labor Relations Spec",42.25,2,75,49.49,20,109,91.74,22,184,0.85,"no men in title"
"395","Labor Standards Tech",49.65,16,102,29.99,1,103,79.64,17,205,1.66,"no women in title"
"396","Labor Standards Tech Supv",33.69,1,67,49.49,20,109,83.18,21,176,0.68,"no men in title"
"397","Laborer",20.96,14,85,21.08,60,85,42.04,74,170,0.99,""
"398","Laborer-Inserting Machine Op",49.65,16,102,21.14,1,143,70.79,17,245,2.35,"no women in title"
"399","Land Use Plnr I",35.63,3,0,49.49,20,109,85.12,23,109,0.72,"no men in title"
"400","Land Use Plnr II",39.2,4,144,37.82,4,98,77.02,8,242,1.04,""
"401","Land Use Plnr III",41.16,7,44,41.97,11,82,83.13,18,126,0.98,""
"402","Land Use Plnr IV",44.74,8,52,44.74,4,121,89.48,12,173,1,""
"403","Landscape Architect,Sr",44.74,3,186,44.74,1,175,89.48,4,361,1,""
"404","Landscape Designer",30.85,1,62,49.49,20,109,80.34,21,171,0.62,"no men in title"
"405","Landscape Supv",33.93,2,255,33.93,1,21,67.86,3,276,1,""
"406","Latent Print Examiner",34.55,9,40,36.3,1,245,70.85,10,285,0.95,""
"407","Latent Print Supv",39.96,1,262,49.49,20,109,89.45,21,371,0.81,"no men in title"
"408","Legal Asst",24.9,14,98,23.88,1,15,48.78,15,113,1.04,""
"409","Legislative Asst",32.95,13,70,33.16,14,57,66.11,27,127,0.99,""
"410","Legislative Info Anlyst",49.65,16,102,36.3,1,42,85.95,17,144,1.37,"no women in title"
"411","Legislative Info Spec I",22.96,1,42,22.96,1,42,45.92,2,84,1,""
"412","Legislative Info Spec II",29.41,1,42,49.49,20,109,78.9,21,151,0.59,"no men in title"
"413","Legislative Info Supv",36.3,1,42,49.49,20,109,85.79,21,151,0.73,"no men in title"
"414","Licenses&Standards Inspector",31.89,7,92,33.32,11,194,65.21,18,286,0.96,""
"415","Lifeguard",16.61,3,8,16.39,4,28,33,7,36,1.01,""
"416","Lifeguard,Sr",19.5,12,52,19.46,9,65,38.96,21,117,1,""
"417","Line C CC",47.67,1,174,47.67,31,114,95.34,32,288,1,""
"418","Line CC-Asg C Coord",47.67,1,29,47.67,5,60,95.34,6,89,1,""
"419","Lnwkr",42.37,6,94,42.37,114,80,84.74,120,174,1,""
"420","Lnwkr Aprn",35.17,1,20,35.24,17,28,70.41,18,48,1,""
"421","Lnwkr-Asg Pwrline Clearance",49.65,16,102,45.47,1,29,95.12,17,131,1.09,"no women in title"
"422","Lnwrkr-Asg Locator",49.65,16,102,42.37,1,38,92.02,17,140,1.17,"no women in title"
"423","Lock Tech",49.65,16,102,27.78,2,147,77.43,18,249,1.79,"no women in title"
"424","Lock Tech,Sr",29.99,1,149,49.49,20,109,79.48,21,258,0.61,"no men in title"
"425","Mach Spec",27.51,1,307,26.78,3,54,54.29,4,361,1.03,""
"426","Magistrate",52.25,2,152,51.27,4,102,103.52,6,254,1.02,""
"427","Maint Laborer",23.38,35,98,23.38,161,80,46.76,196,178,1,""
"428","Maint Laborer,Sr-Traffic",25.04,3,129,25.04,7,78,50.08,10,207,1,""
"429","Manager1,CL&PS",40.71,3,47,47.3,1,74,88.01,4,121,0.86,""
"430","Manager1,CSPI&P",43.13,7,119,49.49,20,109,92.62,27,228,0.87,"no men in title"
"431","Manager1,Exempt",47.33,1,147,34.55,1,15,81.88,2,162,1.37,""
"432","Manager1,Fin,Bud,&Actg",43.38,8,68,43.56,3,46,86.94,11,114,1,""
"433","Manager1,General Govt",43.02,7,57,37.62,2,40,80.64,9,97,1.14,""
"434","Manager1,Human Svcs",38.55,2,9,39.82,2,50,78.37,4,59,0.97,""
"435","Manager1,Info Technol",46.73,1,68,49.49,20,109,96.22,21,177,0.94,"no men in title"
"436","Manager1,P&FM",40.2,1,121,42.24,3,92,82.44,4,213,0.95,""
"437","Manager1,P&FM-BU",49.65,16,102,45.12,1,57,94.77,17,159,1.1,"no women in title"
"438","Manager1,Parks&Rec",42.14,4,58,39.19,4,46,81.33,8,104,1.08,""
"439","Manager1,PC&RM-BU",46.41,2,16,49.49,20,109,95.9,22,125,0.94,"no men in title"
"440","Manager1,Utils",49.65,16,102,47.91,2,30,97.56,18,132,1.04,"no women in title"
"441","Manager1,Utils-BU",41.37,1,63,47.39,1,0,88.76,2,63,0.87,""
"442","Manager2,CL&PS",45.03,2,142,47.28,1,132,92.31,3,274,0.95,""
"443","Manager2,CSPI&P",45.93,4,81,46.85,4,77,92.78,8,158,0.98,""
"444","Manager2,CSPI&P-BU",49.65,16,102,48.73,1,53,98.38,17,155,1.02,"no women in title"
"445","Manager2,Engrng&Plans Rev",51.07,4,70,50.27,13,70,101.34,17,140,1.02,""
"446","Manager2,Engrng&Plans Rev-BU",51.45,1,41,49.49,20,109,100.94,21,150,1.04,"no men in title"
"447","Manager2,Exempt",49.22,6,51,47.45,6,67,96.67,12,118,1.04,""
"448","Manager2,Fin,Bud,&Actg",48.59,10,64,49.86,4,49,98.45,14,113,0.97,""
"449","Manager2,Fin,Bud,&Actg-BU",45.03,2,108,49.24,4,130,94.27,6,238,0.91,""
"450","Manager2,General Govt",50.15,9,91,50.3,7,53,100.45,16,144,1,""
"451","Manager2,Human Svcs",43.39,7,61,46.42,2,80,89.81,9,141,0.93,""
"452","Manager2,Info Technol",47.66,4,69,51.48,6,111,99.14,10,180,0.93,""
"453","Manager2,P&FM",49.12,3,44,50.19,3,28,99.31,6,72,0.98,""
"454","Manager2,P&FM-BU",49.65,16,102,48.61,1,57,98.26,17,159,1.02,"no women in title"
"455","Manager2,Parks&Rec",47.68,4,123,47.5,2,115,95.18,6,238,1,""
"456","Manager2,PC&RM",50.29,1,3,49.49,20,109,99.78,21,112,1.02,"no men in title"
"457","Manager2,PC&RM-BU",49.65,16,102,46.94,1,74,96.59,17,176,1.06,"no women in title"
"458","Manager2,Utils",52.14,9,72,51.35,12,88,103.49,21,160,1.02,""
"459","Manager2,Utils-BU",51.33,2,60,49.16,5,33,100.49,7,93,1.04,""
"460","Manager3,CL&PS",49.65,16,102,50.78,1,64,100.43,17,166,0.98,"no women in title"
"461","Manager3,CSPI&P",51.56,1,39,50.07,1,122,101.63,2,161,1.03,""
"462","Manager3,Engrng&Plans Rev",55.58,9,112,56.67,21,77,112.25,30,189,0.98,""
"463","Manager3,Engrng&Plans Rev-BU",60.56,1,74,59.78,3,48,120.34,4,122,1.01,""
"464","Manager3,Exempt",52.21,4,20,53.8,6,29,106.01,10,49,0.97,""
"465","Manager3,Exempt-BU",55.52,2,46,49.49,20,109,105.01,22,155,1.12,"no men in title"
"466","Manager3,Fin,Bud,&Actg",52.7,4,68,52.7,3,37,105.4,7,105,1,""
"467","Manager3,General Govt",56.25,6,38,53.63,3,25,109.88,9,63,1.05,""
"468","Manager3,Human Svcs",49.28,2,12,49.49,20,109,98.77,22,121,1,"no men in title"
"469","Manager3,Info Technol",57.86,4,73,59.36,3,102,117.22,7,175,0.97,""
"470","Manager3,Info Technol-BU",49.65,16,102,58.8,1,14,108.45,17,116,0.84,"no women in title"
"471","Manager3,P&FM",49.65,16,102,56.2,5,31,105.85,21,133,0.88,"no women in title"
"472","Manager3,Parks&Rec",49.65,16,102,52,1,1,101.65,17,103,0.95,"no women in title"
"473","Manager3,PC&RM",52.69,2,46,49.49,20,109,102.18,22,155,1.06,"no men in title"
"474","Manager3,Utils",49.65,16,102,55.65,12,95,105.3,28,197,0.89,"no women in title"
"475","Manager3,Utils-BU",58.24,4,38,57.91,9,67,116.15,13,105,1.01,""
"476","Marine Equip Svcr",49.65,16,102,34.32,1,24,83.97,17,126,1.45,"no women in title"
"477","Marketing Dev Coord",38.85,4,39,49.49,20,109,88.34,24,148,0.79,"no men in title"
"478","Mat Controller,Prin-BU",35.14,3,8,49.49,20,109,84.63,23,117,0.71,"no men in title"
"479","Mat Controller,Sr",31.16,1,160,49.49,20,109,80.65,21,269,0.63,"no men in title"
"480","Mat Controller,Sr-BU",30.16,2,8,30.16,1,8,60.32,3,16,1,""
"481","Mat Controller-BU",24.95,1,8,49.49,20,109,74.44,21,117,0.5,"no men in title"
"482","Mat Handling Supv,General",49.65,16,102,37.7,1,35,87.35,17,137,1.32,"no women in title"
"483","Mat Handling Supv,General-BU",37.7,1,167,49.49,20,109,87.19,21,276,0.76,"no men in title"
"484","Mat Suplr,Elec-Asg Equip Cust",38.2,1,63,38.2,1,25,76.4,2,88,1,""
"485","Mat Suplr,Elec-Asg Phd/Cw/D",33.96,1,1,33.96,4,71,67.92,5,72,1,""
"486","Mat Suplr-Asg Leo/Pdm/Hb",34.13,1,89,36.09,11,79,70.22,12,168,0.95,""
"487","MatSup,Elec-Asg Cs &/or Cdt",49.65,16,102,31.05,17,62,80.7,33,164,1.6,"no women in title"
"488","MatSup,Elec-Asg OPVTCHBNSTR",49.65,16,102,32.02,8,56,81.67,24,158,1.55,"no women in title"
"489","Mayor",49.65,16,102,86.11,1,40,135.76,17,142,0.58,"no women in title"
"490","Mayoral Staff Asst 1",22.73,2,2,22.74,2,8,45.47,4,10,1,""
"491","Mayoral Staff Asst 2",30.07,8,37,28.6,3,40,58.67,11,77,1.05,""
"492","Mech Engr Supv",49.65,16,102,54.66,1,157,104.31,17,259,0.91,"no women in title"
"493","Mech Engr,Assoc",49.65,16,102,40.86,1,382,90.51,17,484,1.22,"no women in title"
"494","Mech Engr,Sr",49.65,16,102,50.69,6,115,100.34,22,217,0.98,"no women in title"
"495","Mech Inspector Supv",49.65,16,102,43.91,1,124,93.56,17,226,1.13,"no women in title"
"496","Mech Inspector(J)",49.65,16,102,38.81,3,81,88.46,19,183,1.28,"no women in title"
"497","Mech Plans Engr",49.65,16,102,41.55,1,6,91.2,17,108,1.19,"no women in title"
"498","Mech Plans Engr Supv",49.65,16,102,53.39,1,7,103.04,17,109,0.93,"no women in title"
"499","Mech Plans Engr,Sr",50.07,1,43,44.8,1,7,94.87,2,50,1.12,""
"500","Metal Fabricator",32.54,1,244,32.54,6,175,65.08,7,419,1,""
"501","Metal Fabricator CC",49.65,16,102,34.57,2,46,84.22,18,148,1.44,"no women in title"
"502","Meter Elctn",41.14,3,46,41.14,22,46,82.28,25,92,1,""
"503","Meter Elctn Aprn",49.65,16,102,31.68,2,15,81.33,18,117,1.57,"no women in title"
"504","Meter Elctn Working CC",46.28,1,23,46.28,7,44,92.56,8,67,1,""
"505","Meter Reader",22.86,12,131,23,41,125,45.86,53,256,0.99,""
"506","Meter Reader Supv",49.65,16,102,30.69,3,82,80.34,19,184,1.62,"no women in title"
"507","Meter Reader,Sr",27.31,2,152,26.72,7,91,54.03,9,243,1.02,""
"508","Mgmt Systs Anlyst",35.4,24,63,34.27,9,41,69.67,33,104,1.03,""
"509","Mgmt Systs Anlyst Supv",47.26,2,74,45.58,2,64,92.84,4,138,1.04,""
"510","Mgmt Systs Anlyst Supv-BU",49.65,16,102,47.26,1,74,96.91,17,176,1.05,"no women in title"
"511","Mgmt Systs Anlyst,Asst",31.23,13,51,31.28,5,50,62.51,18,101,1,""
"512","Mgmt Systs Anlyst,Sr",41.79,40,58,41.81,25,67,83.6,65,125,1,""
"513","Muni Court Marshal",49.65,16,102,30.24,9,83,79.89,25,185,1.64,"no women in title"
"514","Muni Court Marshal,Sr",35.39,1,16,49.49,20,109,84.88,21,125,0.72,"no men in title"
"515","Muni Judge",64.48,3,191,64.48,4,88,128.96,7,279,1,""
"516","Naturalist",26.28,2,70,27.78,1,142,54.06,3,212,0.95,""
"517","Naturalist,Sr",29.99,1,52,49.49,20,109,79.48,21,161,0.61,"no men in title"
"518","Neighb District Coord",37.7,3,90,37.7,6,117,75.4,9,207,1,""
"519","Noise Contrl Prgm Spec",49.65,16,102,39.96,2,146,89.61,18,248,1.24,"no women in title"
"520","Ofc Asst-BU",17.99,1,99,49.49,20,109,67.48,21,208,0.36,"no men in title"
"521","Ofc Equip Op",20.61,1,216,49.49,20,109,70.1,21,325,0.42,"no men in title"
"522","Ofc/Maint Aide",14.45,19,109,14.75,37,80,29.2,56,189,0.98,""
"523","OPA Review Board Member",5.11,2,19,5.11,3,30,10.22,5,49,1,""
"524","Opns CC,Sr-SC",49.65,16,102,33.71,2,34,83.36,18,136,1.47,"no women in title"
"525","Opns CC-SC",49.65,16,102,32.35,1,106,82,17,208,1.53,"no women in title"
"526","Opns Response Cntr Op",29.44,4,48,29.61,3,58,59.05,7,106,0.99,""
"527","Overhead Elecl Suplr",49.65,16,102,30.9,1,334,80.55,17,436,1.61,"no women in title"
"528","Paint&Body Supv",49.65,16,102,34.75,1,99,84.4,17,201,1.43,"no women in title"
"529","Paralegal",30.71,13,68,30.91,4,87,61.62,17,155,0.99,""
"530","Paralegal Asst II",26.45,3,130,26.79,1,195,53.24,4,325,0.99,""
"531","Park Horticulturist",44.74,1,141,49.49,20,109,94.23,21,250,0.9,"no men in title"
"532","Park Ranger",23.42,2,47,23.88,4,49,47.3,6,96,0.98,""
"533","Parking Attendant",49.65,16,102,19.87,3,103,69.52,19,205,2.5,"no women in title"
"534","Parking Attendant,Sr",22.82,1,38,49.49,20,109,72.31,21,147,0.46,"no men in title"
"535","Parking Enf Ofcr",24.53,50,124,24.51,55,86,49.04,105,210,1,""
"536","Parking Enf Ofcr Supv",29.64,3,29,30.27,9,59,59.91,12,88,0.98,""
"537","Parking Meter Collector",49.65,16,102,21.36,5,227,71.01,21,329,2.32,"no women in title"
"538","Parking Meter Collector,Supvsg",49.65,16,102,25.77,1,190,75.42,17,292,1.93,"no women in title"
"539","Parking Pay Stat Shop,Supv",35.18,1,40,49.49,20,109,84.67,21,149,0.71,"no men in title"
"540","Parking Pay Stat Tech",49.65,16,102,29.49,6,152,79.14,22,254,1.68,"no women in title"
"541","Parking&Traffic Coord",26.79,1,159,49.49,20,109,76.28,21,268,0.54,"no men in title"
"542","Parks Concss Coord",36.99,2,96,49.49,20,109,86.48,22,205,0.75,"no men in title"
"543","Parks Maint Aide",49.65,16,102,14.48,8,46,64.13,24,148,3.43,"no women in title"
"544","Parks Maint CC",36.05,4,20,36.05,3,21,72.1,7,41,1,""
"545","Parks Special Events Schdlr,Sr",25.28,1,11,28.35,2,16,53.63,3,27,0.89,""
"546","Parks Special Events Schedlr",26.26,5,135,26.26,1,75,52.52,6,210,1,""
"547","Passenger & Tugboat Op",49.65,16,102,29.68,1,144,79.33,17,246,1.67,"no women in title"
"548","Passenger & Tugboat Op,Sr",49.65,16,102,32.67,1,84,82.32,17,186,1.52,"no women in title"
"549","Payroll Supv",37.7,4,142,37.7,1,16,75.4,5,158,1,""
"550","Permit Process Leader",42.6,3,34,44.74,3,101,87.34,6,135,0.95,""
"551","Permit Spec I",31.61,12,47,31.59,3,44,63.2,15,91,1,""
"552","Permit Spec II",31.84,4,0,31.97,5,29,63.81,9,29,1,""
"553","Permit Spec Supv",49.65,16,102,37.7,1,84,87.35,17,186,1.32,"no women in title"
"554","Permit Tech",26.99,6,41,28.35,2,81,55.34,8,122,0.95,""
"555","Permit Tech Supv",33.69,1,33,49.49,20,109,83.18,21,142,0.68,"no men in title"
"556","Personnel Anlyst",36.3,3,72,49.49,20,109,85.79,23,181,0.73,"no men in title"
"557","Personnel Anlyst Supv",49.05,2,46,49.49,20,109,98.54,22,155,0.99,"no men in title"
"558","Personnel Anlyst Supv-Comp",49.05,1,64,49.49,20,109,98.54,21,173,0.99,"no men in title"
"559","Personnel Anlyst,Sr",40.27,3,61,49.49,20,109,89.76,23,170,0.81,"no men in title"
"560","Personnel Anlyst,Sr-Comp",39.97,2,16,42.25,2,54,82.22,4,70,0.95,""
"561","Personnel Spec",32.39,18,74,33.69,5,87,66.08,23,161,0.96,""
"562","Personnel Spec,Asst",26.08,11,66,25.82,3,51,51.9,14,117,1.01,""
"563","Personnel Spec,Sr",35.45,20,61,36.3,5,79,71.75,25,140,0.98,""
"564","Personnel Spec,Supvsng",49.65,16,102,43.91,2,122,93.56,18,224,1.13,"no women in title"
"565","Photographer,Sr",49.65,16,102,32.79,2,178,82.44,18,280,1.51,"no women in title"
"566","Photographic Svcs Supv",49.65,16,102,35.43,1,23,85.08,17,125,1.4,"no women in title"
"567","Plng&Dev Spec I",34.17,8,88,34.94,2,155,69.11,10,243,0.98,""
"568","Plng&Dev Spec II",37.54,33,105,37.21,11,97,74.75,44,202,1.01,""
"569","Plng&Dev Spec,Sr",41.6,30,57,42.32,28,64,83.92,58,121,0.98,""
"570","Plng&Dev Spec,Supvsng",45.74,5,58,46.41,3,44,92.15,8,102,0.99,""
"571","Plng&Dev Spec,Supvsng-BU",46.41,1,47,49.49,20,109,95.9,21,156,0.94,"no men in title"
"572","Plnt Ecologist",33.09,1,35,31.82,2,34,64.91,3,69,1.04,""
"573","Plumber",49.65,16,102,34.08,16,149,83.73,32,251,1.46,"no women in title"
"574","Plumber Aprn",49.65,16,102,28.78,1,59,78.43,17,161,1.73,"no women in title"
"575","Plumber CC",49.65,16,102,40.59,2,104,90.24,18,206,1.22,"no women in title"
"576","Plumber,Sr",36.9,1,127,36.9,2,136,73.8,3,263,1,""
"577","Pmp Stat CC",49.65,16,102,40.76,1,77,90.41,17,179,1.22,"no women in title"
"578","Pmp Stat Elecl Tech",49.65,16,102,36.34,5,75,85.99,21,177,1.37,"no women in title"
"579","Pmp Stat Elecl Tech,Sr",49.65,16,102,38.45,3,83,88.1,19,185,1.29,"no women in title"
"580","Pmp Stat Maint Lead Wkr CII",49.65,16,102,27.61,1,6,77.26,17,108,1.8,"no women in title"
"581","Pmp Stat Maint Leadwkr",28.1,1,120,28.1,3,125,56.2,4,245,1,""
"582","Pmp Stat Maint Wkr",49.65,16,102,23.17,1,1,72.82,17,103,2.14,"no women in title"
"583","Pmp Stat Maint Wkr CI",25.54,1,31,25.54,1,11,51.08,2,42,1,""
"584","Pntr",30.28,1,284,30.28,11,153,60.56,12,437,1,""
"585","Pntr CC",49.65,16,102,34.75,3,181,84.4,19,283,1.43,"no women in title"
"586","Pntr,Sr",49.65,16,102,31.66,2,48,81.31,18,150,1.57,"no women in title"
"587","Pol Capt",49.65,16,102,75.26,10,53,124.91,26,155,0.66,"no women in title"
"588","Pol Capt - Permanent Night",49.65,16,102,80.23,1,28,129.88,17,130,0.62,"no women in title"
"589","Pol Capt - Traffic",49.65,16,102,78.92,1,4,128.57,17,106,0.63,"no women in title"
"590","Pol Capt - Violent Crime",49.65,16,102,80.23,1,6,129.88,17,108,0.62,"no women in title"
"591","Pol Capt-Precinct",81.65,1,40,80.61,4,22,162.26,5,62,1.01,""
"592","Pol Comms Anlyst",36.75,2,85,49.49,20,109,86.24,22,194,0.74,"no men in title"
"593","Pol Comms Dispatcher I",25.12,39,74,24.47,11,31,49.59,50,105,1.03,""
"594","Pol Comms Dispatcher II",30.2,27,93,29.82,7,98,60.02,34,191,1.01,""
"595","Pol Comms Dispatcher III",33.99,7,102,33.62,5,56,67.61,12,158,1.01,""
"596","Pol Comms Dispatcher Supv",40,2,28,40,1,28,80,3,56,1,""
"597","Pol Comms Dispatcher,Chief",37.4,4,45,37.73,2,126,75.13,6,171,0.99,""
"598","Pol Data Tech",24.85,21,106,25.06,2,69,49.91,23,175,0.99,""
"599","Pol Data Tech Supv",29.78,2,64,49.49,20,109,79.27,22,173,0.6,"no men in title"
"600","Pol Data Tech,Sr",26.55,6,152,26.55,1,59,53.1,7,211,1,""
"601","Pol Lieut",62.84,4,90,65.36,37,99,128.2,41,189,0.96,""
"602","Pol Ofcr",39.14,15,40,38.45,135,37,77.59,150,77,1.02,""
"603","Pol Ofcr- Student",34.09,9,1,33.36,28,5,67.45,37,6,1.02,""
"604","Pol Ofcr-Academy Instructor",45.57,1,124,44.44,15,88,90.01,16,212,1.03,""
"605","Pol Ofcr-Canine",45.98,1,68,45.47,12,86,91.45,13,154,1.01,""
"606","Pol Ofcr-Detective",44.55,41,110,44.96,114,121,89.51,155,231,0.99,""
"607","Pol Ofcr-Detective-Bomb Squad",47.18,1,112,47.5,5,151,94.68,6,263,0.99,""
"608","Pol Ofcr-Detective-Homicide",45.17,2,57,46.33,16,114,91.5,18,171,0.97,""
"609","Pol Ofcr-Diver",49.65,16,102,46.99,22,99,96.64,38,201,1.06,"no women in title"
"610","Pol Ofcr-DWI-Am/Pm Enf",44.35,4,92,44.22,13,121,88.57,17,213,1,""
"611","Pol Ofcr-Hostage Neg-Patrl",45.17,2,124,45.32,11,82,90.49,13,206,1,""
"612","Pol Ofcr-Motorcycle",45.57,1,109,45.2,28,168,90.77,29,277,1.01,""
"613","Pol Ofcr-Non Patrol",44.15,2,46,43.55,4,41,87.7,6,87,1.01,""
"614","Pol Ofcr-Patrl",43.91,83,99,44.14,493,116,88.05,576,215,0.99,""
"615","Pol Ofcr-SWAT",49.65,16,102,45,24,107,94.65,40,209,1.1,"no women in title"
"616","Pol Recruit",25.98,1,1,25.98,14,2,51.96,15,3,1,""
"617","Pol Sgt-Academy Instructor",49.65,16,102,51.09,3,50,100.74,19,152,0.97,"no women in title"
"618","Pol Sgt-Canine",49.65,16,102,52.04,1,23,101.69,17,125,0.95,"no women in title"
"619","Pol Sgt-Detective",51.53,8,73,51.52,30,77,103.05,38,150,1,""
"620","Pol Sgt-Detective-Bomb Squad",49.65,16,102,54.46,2,163,104.11,18,265,0.91,"no women in title"
"621","Pol Sgt-Detective-Homicide",49.65,16,102,52.84,3,105,102.49,19,207,0.94,"no women in title"
"622","Pol Sgt-Diver",49.65,16,102,53.85,4,114,103.5,20,216,0.92,"no women in title"
"623","Pol Sgt-DWI-Am/Pm Enf",49.65,16,102,51.83,3,129,101.48,19,231,0.96,"no women in title"
"624","Pol Sgt-Hostage Neg-Patrl",49.65,16,102,52.64,2,58,102.29,18,160,0.94,"no women in title"
"625","Pol Sgt-Motorcycle",49.65,16,102,51.36,3,49,101.01,19,151,0.97,"no women in title"
"626","Pol Sgt-Non Patrol",51.83,1,66,49.49,20,109,101.32,21,175,1.05,"no men in title"
"627","Pol Sgt-Patrl",51.98,8,97,52.14,72,89,104.12,80,186,1,""
"628","Pol Sgt-SWAT",49.65,16,102,52.64,4,52,102.29,20,154,0.94,"no women in title"
"629","Pole Yard CC",49.65,16,102,38.2,1,96,87.85,17,198,1.3,"no women in title"
"630","Pool Maint Lead Wkr",49.65,16,102,28.35,1,222,78,17,324,1.75,"no women in title"
"631","Pool Maint Wkr",25.54,3,102,25.54,6,202,51.08,9,304,1,""
"632","Pressure Systs Inspector(J)",49.65,16,102,38.14,4,100,87.79,20,202,1.3,"no women in title"
"633","Pressure Systs Inspector,Chief",49.65,16,102,44.74,1,138,94.39,17,240,1.11,"no women in title"
"634","Prgm Intake Rep",26.46,17,73,26.42,5,113,52.88,22,186,1,""
"635","Prgm Intake Rep,Sr",28.84,1,16,49.49,20,109,78.33,21,125,0.58,"no men in title"
"636","Prjt Fund&Agreemts Coord",35.85,3,113,36.3,1,306,72.15,4,419,0.99,""
"637","Prjt Fund&Agreemts Coord,Sr",39.96,3,66,39.96,3,86,79.92,6,152,1,""
"638","Prjt Fund&Agreemts Coord,Supv",36.99,1,2,49.49,20,109,86.48,21,111,0.75,"no men in title"
"639","Prob Counslr I",36.07,8,141,35.07,6,92,71.14,14,233,1.03,""
"640","Prob Counslr II",39.36,3,78,38.76,7,59,78.12,10,137,1.02,""
"641","Prob Counslr II-NR",39.36,1,63,49.49,20,109,88.85,21,172,0.8,"no men in title"
"642","Prob Counslr-Asg Pers Recog",34.23,5,82,34.99,3,229,69.22,8,311,0.98,""
"643","Prob Supv",44.83,1,71,49.49,20,109,94.32,21,180,0.91,"no men in title"
"644","Property Mgmt Spec",45.51,3,89,44.71,2,51,90.22,5,140,1.02,""
"645","Property Rehab Spec",49.65,16,102,35.34,7,84,84.99,23,186,1.4,"no women in title"
"646","Prot&Cntrl Elctn CC",49.65,16,102,54.61,1,136,104.26,17,238,0.91,"no women in title"
"647","Prot&Cntrl Elctn II",48.54,1,136,48.54,9,80,97.08,10,216,1,""
"648","Publc Ed Prgm Spec",31.16,7,114,31.16,3,63,62.32,10,177,1,""
"649","Publc Ed Prgm Supv",39.2,1,51,39.2,1,76,78.4,2,127,1,""
"650","Publc Relations Spec",29.38,5,38,49.49,20,109,78.87,25,147,0.59,"no men in title"
"651","Publc Relations Spec,Sr",35.66,8,74,36.07,6,63,71.73,14,137,0.99,""
"652","Publc Relations Supv",39.2,2,163,49.49,20,109,88.69,22,272,0.79,"no men in title"
"653","Publc/Cultural Prgms Spec",29.99,1,103,49.49,20,109,79.48,21,212,0.61,"no men in title"
"654","Publc/Cultural Prgms Spec,Sr",35.43,3,73,49.49,20,109,84.92,23,182,0.72,"no men in title"
"655","Pwr Anlyst",39.37,3,67,49.49,20,109,88.86,23,176,0.8,"no men in title"
"656","Pwr Anlyst,Asst",30.14,1,29,49.49,20,109,79.63,21,138,0.61,"no men in title"
"657","Pwr Anlyst,Sr",43.94,5,24,45.25,2,92,89.19,7,116,0.97,""
"658","Pwr Dispatcher",49.84,2,85,49.63,8,68,99.47,10,153,1,""
"659","Pwr Dispatcher,Asst",40.36,1,7,39.33,3,2,79.69,4,9,1.03,""
"660","Pwr Dispatcher,Sr",49.65,16,102,56.35,9,91,106,25,193,0.88,"no women in title"
"661","Pwr Marketer",57.53,3,115,51.83,15,89,109.36,18,204,1.11,""
"662","Pwr Structs Mechanic",35.88,2,22,35.88,11,127,71.76,13,149,1,""
"663","Pwr Structs Mechanic CC",41.14,1,123,41.14,5,53,82.28,6,176,1,""
"664","Pwr Supply Engr",49.65,16,102,64.61,1,81,114.26,17,183,0.77,"no women in title"
"665","Pwrline Clear Tree Trimmer",49.65,16,102,38.81,1,107,88.46,17,209,1.28,"no women in title"
"666","Pwrline Clear Tree Trimmer-JIC",49.65,16,102,41.14,1,92,90.79,17,194,1.21,"no women in title"
"667","Radio Comms Spec",49.65,16,102,33.69,1,32,83.34,17,134,1.47,"no women in title"
"668","Radio Dispatcher",24.35,9,113,24.35,2,56,48.7,11,169,1,""
"669","Rates Mgmt Anlyst,Sr",44.74,1,52,49.49,20,109,94.23,21,161,0.9,"no men in title"
"670","Real Property Agent",49.65,16,102,38.22,3,33,87.87,19,135,1.3,"no women in title"
"671","Real Property Agent,Sr",44.84,9,107,45.02,9,96,89.86,18,203,1,""
"672","Rec Attendant",16.76,20,82,16.45,21,113,33.21,41,195,1.02,""
"673","Rec Cntr Coord",32.2,15,95,31.93,8,78,64.13,23,173,1.01,""
"674","Rec Cntr Coord,Asst",29.54,6,127,29.54,4,112,59.08,10,239,1,""
"675","Rec Leader",23.82,18,65,24.28,23,80,48.1,41,145,0.98,""
"676","Rec Prgm Coord",33.69,2,48,32.95,5,75,66.64,7,123,1.02,""
"677","Rec Prgm Coord,Sr",36.3,2,50,36.3,6,56,72.6,8,106,1,""
"678","Rec Prgm Spec",28.39,18,90,28.03,5,42,56.42,23,132,1.01,""
"679","Rec Prgm Spec,Sr",31.76,3,129,31.76,2,131,63.52,5,260,1,""
"680","Registered Nurse Consultant",36.3,4,60,36.3,1,1,72.6,5,61,1,""
"681","Remittance Proc Tech",22.56,2,213,49.49,20,109,72.05,22,322,0.46,"no men in title"
"682","Remittance Proc Tech,Sr",24.35,1,268,49.49,20,109,73.84,21,377,0.49,"no men in title"
"683","Res&Eval Aide",22.77,4,38,21.78,2,4,44.55,6,42,1.05,""
"684","Res&Eval Asst",29.41,3,141,29.41,1,99,58.82,4,240,1,""
"685","Res&Eval Asst II",39.96,1,65,49.49,20,109,89.45,21,174,0.81,"no men in title"
"686","Res&Eval Asst-BU",28.36,3,72,49.49,20,109,77.85,23,181,0.57,"no men in title"
"687","Retirement Spec",24.97,3,16,25.28,1,15,50.25,4,31,0.99,""
"688","Rights-Of-Way Maint Lead Wkr",49.65,16,102,28.09,1,1,77.74,17,103,1.77,"no women in title"
"689","Rights-Of-Way Maint Wkr",27.52,1,216,27.52,7,144,55.04,8,360,1,""
"690","Risk Mgmt Anlyst",49.65,16,102,36.3,1,75,85.95,17,177,1.37,"no women in title"
"691","Scale Attendant",22.78,2,78,22.78,6,88,45.56,8,166,1,""
"692","Seattle Conserv Corps Supv",49.65,16,102,26.5,7,52,76.15,23,154,1.87,"no women in title"
"693","Seattle Conserv Corps Supv,Sr",49.65,16,102,29.41,2,48,79.06,18,150,1.69,"no women in title"
"694","Security Ofcr",22.81,1,114,22.81,14,138,45.62,15,252,1,""
"695","Security Ofcr,Sr",49.65,16,102,25,3,129,74.65,19,231,1.99,"no women in title"
"696","Security Prgms Spec",34.94,1,60,34.94,2,92,69.88,3,152,1,""
"697","Security Supv",49.65,16,102,31.76,1,19,81.41,17,121,1.56,"no women in title"
"698","Sfty&Hlth Spec",39.2,1,169,39.2,1,64,78.4,2,233,1,""
"699","Sfty&Hlth Spec,Sr",42,6,86,40.9,9,47,82.9,15,133,1.03,""
"700","Sfty&Hlth Spec,Sr-BU",49.65,16,102,40.74,1,5,90.39,17,107,1.22,"no women in title"
"701","Sfty&Hlth Supv",45.51,1,16,43.88,2,22,89.39,3,38,1.04,""
"702","Sfty/Ocuptnl Hlth Coord",42.25,1,64,49.49,20,109,91.74,21,173,0.85,"no men in title"
"703","Shop Opns Supv",49.65,16,102,41.55,5,91,91.2,21,193,1.19,"no women in title"
"704","Sign Inspector(J)",49.65,16,102,39.2,1,7,88.85,17,109,1.27,"no women in title"
"705","Sign Pntr,Sr",49.65,16,102,31.66,2,114,81.31,18,216,1.57,"no women in title"
"706","Signal Elctn CC",46.06,1,239,46.06,1,37,92.12,2,276,1,""
"707","Signal Elctn II",49.65,16,102,40.95,3,17,90.6,19,119,1.21,"no women in title"
"708","Signal Elctn III",49.65,16,102,41.77,7,51,91.42,23,153,1.19,"no women in title"
"709","Signal Elctn V",43.41,1,62,43.41,7,119,86.82,8,181,1,""
"710","Site Dev Insp",40.74,2,91,39.63,4,69,80.37,6,160,1.03,""
"711","Social Svcs Aide",19.53,6,11,19.97,3,17,39.5,9,28,0.98,""
"712","Solid Wst Fld Rep II",34.1,1,46,34.1,3,91,68.2,4,137,1,""
"713","Solid Wst Fld Rep Supv",49.65,16,102,40.04,3,159,89.69,19,261,1.24,"no women in title"
"714","Solid Wst Fld Rep,Lead",37.06,1,3,37.06,4,80,74.12,5,83,1,""
"715","Sound Systs Chief",49.65,16,102,35.57,1,90,85.22,17,192,1.4,"no women in title"
"716","Sound&Video Equip Tech",32.01,1,119,32.01,6,110,64.02,7,229,1,""
"717","Spay&Neuter Tech",24.35,3,203,49.49,20,109,73.84,23,312,0.49,"no men in title"
"718","Special Asst-Law",43.1,1,40,49.49,20,109,92.59,21,149,0.87,"no men in title"
"719","Special C Lead Wkr",49.65,16,102,28.35,1,226,78,17,328,1.75,"no women in title"
"720","Special Exams Anlyst",36.3,2,182,49.49,20,109,85.79,22,291,0.73,"no men in title"
"721","Stage CC",49.65,16,102,35.57,1,36,85.22,17,138,1.4,"no women in title"
"722","Stage Tech",28.03,1,35,49.49,20,109,77.52,21,144,0.57,"no men in title"
"723","Stage Tech,Lead",30.22,3,185,30.05,7,86,60.27,10,271,1.01,""
"724","Stat Mach CC",49.65,16,102,34.51,1,0,84.16,17,102,1.44,"no women in title"
"725","Stat Maint Mach",49.65,16,102,31.4,2,149,81.05,18,251,1.58,"no women in title"
"726","Store Clerk",21.14,1,92,49.49,20,109,70.63,21,201,0.43,"no men in title"
"727","Store Keeper",49.65,16,102,28.35,1,53,78,17,155,1.75,"no women in title"
"728","StratAdvsr1,CL&PS",44.84,2,50,49.49,20,109,94.33,22,159,0.91,"no men in title"
"729","StratAdvsr1,CSPI&P",41.76,10,52,45.64,4,62,87.4,14,114,0.91,""
"730","StratAdvsr1,Engrng&Plans Rev",41.61,1,5,46.35,2,59,87.96,3,64,0.9,""
"731","StratAdvsr1,Exempt",40.03,12,35,41.3,5,26,81.33,17,61,0.97,""
"732","StratAdvsr1,Fin,Bud,&Actg",46.47,2,32,42.61,3,53,89.08,5,85,1.09,""
"733","StratAdvsr1,Fin,Bud,&Actg-BU",49.65,16,102,45.57,1,62,95.22,17,164,1.09,"no women in title"
"734","StratAdvsr1,General Govt",42.34,9,67,44.95,11,46,87.29,20,113,0.94,""
"735","StratAdvsr1,Human Svcs",41.72,3,80,37.36,1,55,79.08,4,135,1.12,""
"736","StratAdvsr1,Info Technol",45.22,1,19,49.49,20,109,94.71,21,128,0.91,"no men in title"
"737","StratAdvsr1,Parks&Rec",39.76,3,68,42.38,2,114,82.14,5,182,0.94,""
"738","StratAdvsr1,PC&RM",47.76,2,20,49.49,20,109,97.25,22,129,0.97,"no men in title"
"739","StratAdvsr1,Utils",45.13,5,59,45.37,7,65,90.5,12,124,0.99,""
"740","StratAdvsr1,Utils-BU",43.01,2,50,48,1,59,91.01,3,109,0.9,""
"741","StratAdvsr2,CL&PS",46.01,5,63,49.6,4,26,95.61,9,89,0.93,""
"742","StratAdvsr2,CSPI&P",45.3,3,51,47,2,6,92.3,5,57,0.96,""
"743","StratAdvsr2,CSPI&P-BU",49.65,16,102,44.13,2,30,93.78,18,132,1.13,"no women in title"
"744","StratAdvsr2,Engrng&Plans Rev",49.43,7,42,50.84,15,76,100.27,22,118,0.97,""
"745","StratAdvsr2,Exempt",46.08,46,38,45.83,28,35,91.91,74,73,1.01,""
"746","StratAdvsr2,Exempt-BU",46.3,1,58,44.98,1,160,91.28,2,218,1.03,""
"747","StratAdvsr2,Fin,Bud,&Actg",48.77,5,39,46.12,1,38,94.89,6,77,1.06,""
"748","StratAdvsr2,Fin,Bud,&Actg-BU",43.16,2,96,49.39,5,53,92.55,7,149,0.87,""
"749","StratAdvsr2,General Govt",48.09,29,62,49.61,27,62,97.7,56,124,0.97,""
"750","StratAdvsr2,General Govt-BU",50.21,4,53,48.74,4,83,98.95,8,136,1.03,""
"751","StratAdvsr2,Human Svcs",45.61,6,45,49.49,20,109,95.1,26,154,0.92,"no men in title"
"752","StratAdvsr2,Info Technol",47.52,1,3,49.89,1,2,97.41,2,5,0.95,""
"753","StratAdvsr2,P&FM",47.26,2,84,49.49,20,109,96.75,22,193,0.95,"no men in title"
"754","StratAdvsr2,PC&RM",46.41,3,48,47.5,1,64,93.91,4,112,0.98,""
"755","StratAdvsr2,PC&RM-BU",49.65,16,102,45.37,1,51,95.02,17,153,1.09,"no women in title"
"756","StratAdvsr2,Utils",50.09,10,70,50.46,11,78,100.55,21,148,0.99,""
"757","StratAdvsr2,Utils-BU",50.02,9,38,50.57,13,67,100.59,22,105,0.99,""
"758","StratAdvsr3,Engrng&Plans Rev",49.65,16,102,48.14,1,100,97.79,17,202,1.03,"no women in title"
"759","StratAdvsr3,Exempt",55.65,17,50,55.11,18,40,110.76,35,90,1.01,""
"760","StratAdvsr3,Exempt-BU",50.01,1,3,49.49,20,109,99.5,21,112,1.01,"no men in title"
"761","StratAdvsr3,Fin,Bud,&Actg",49.65,16,102,50.97,1,52,100.62,17,154,0.97,"no women in title"
"762","StratAdvsr3,General Govt",52.58,6,62,55.38,7,66,107.96,13,128,0.95,""
"763","StratAdvsr3,Info Technol",53.96,1,45,49.49,20,109,103.45,21,154,1.09,"no men in title"
"764","StratAdvsr3,Info Technol-BU",49.65,16,102,53.58,1,43,103.23,17,145,0.93,"no women in title"
"765","StratAdvsr3,Utils",58.23,2,72,50.63,1,141,108.86,3,213,1.15,""
"766","StratAdvsr3,Utils-BU",55.58,1,24,55.81,3,50,111.39,4,74,1,""
"767","StratAdvsr-Audit",52.4,7,99,47.52,1,10,99.92,8,109,1.1,""
"768","StratAdvsr-Legislative",49.03,10,117,47.99,13,88,97.02,23,205,1.02,""
"769","Street Maint CC",33.38,1,54,33.04,4,45,66.42,5,99,1.01,""
"770","Street Maint Supv",36,2,58,36,1,70,72,3,128,1,""
"771","Street Paving CC",33.93,1,38,33.93,6,45,67.86,7,83,1,""
"772","Strucl Iron Wkr",41.14,1,19,40.92,9,162,82.06,10,181,1.01,""
"773","Strucl Iron Wkr CC",46.28,1,259,49.49,20,109,95.77,21,368,0.94,"no men in title"
"774","Strucl Plans Engr",45.69,1,0,45.69,5,164,91.38,6,164,1,""
"775","Strucl Plans Engr Supv",53.39,1,7,53.39,1,156,106.78,2,163,1,""
"776","Strucl Plans Engr,Sr",47.44,2,32,50.07,2,68,97.51,4,100,0.95,""
"777","Strucl Pntr",31.34,1,347,31.34,10,50,62.68,11,397,1,""
"778","Strucl Pntr CC",36.02,1,82,36.02,1,15,72.04,2,97,1,""
"779","Supply&Inventory Tech",25.28,1,154,25.28,1,55,50.56,2,209,1,""
"780","Surveyor,Chief",49.65,16,102,45.25,2,94,94.9,18,196,1.1,"no women in title"
"781","Tax Auditor",34.33,4,58,34.31,5,45,68.64,9,103,1,""
"782","Tax Auditor,Asst",31.16,1,128,49.49,20,109,80.65,21,237,0.63,"no men in title"
"783","Tax Auditor,Sr",36.99,1,16,49.49,20,109,86.48,21,125,0.75,"no men in title"
"784","Telecom Syst Installer",49.65,16,102,32.52,1,53,82.17,17,155,1.53,"no women in title"
"785","Telecom Syst Installer,Sr",49.65,16,102,36.57,2,73,86.22,18,175,1.36,"no women in title"
"786","Temp Emplmnt Spec",33.69,1,115,49.49,20,109,83.18,21,224,0.68,"no men in title"
"787","Tennis Instructor",49.65,16,102,22.96,5,101,72.61,21,203,2.16,"no women in title"
"788","Tenprint Supv",35.57,2,168,49.49,20,109,85.06,22,277,0.72,"no men in title"
"789","Title Records Tech",22.56,1,91,49.49,20,109,72.05,21,200,0.46,"no men in title"
"790","Traffic Marking Lead Wkr",27.52,1,32,27.52,5,59,55.04,6,91,1,""
"791","Traffic Sign&Marking CC I",49.65,16,102,33.38,2,70,83.03,18,172,1.49,"no women in title"
"792","Trans Line CC",47.67,1,2,47.67,1,151,95.34,2,153,1,""
"793","Transmission CC-WDM II",37.4,1,7,38.09,2,39,75.49,3,46,0.98,""
"794","Transp Plnr,Assoc",39.96,3,106,38.5,3,46,78.46,6,152,1.04,""
"795","Transp Plnr,Asst",30.55,1,44,30.55,1,154,61.1,2,198,1,""
"796","Transp Plnr,Sr",43.46,5,33,42.85,10,81,86.31,15,114,1.01,""
"797","Treasury Cashier",31.51,3,98,28.88,2,8,60.39,5,106,1.09,""
"798","Treasury Cashier,Sr",34.94,1,182,49.49,20,109,84.43,21,291,0.71,"no men in title"
"799","Tree Trimmer",49.65,16,102,27.36,7,48,77.01,23,150,1.81,"no women in title"
"800","Tree Trimmer,Lead",49.65,16,102,30.25,4,58,79.9,20,160,1.64,"no women in title"
"801","Tree Trimming Rep",49.65,16,102,29.96,1,41,79.61,17,143,1.66,"no women in title"
"802","Trng Dev&Prgm Coord",33.69,1,116,49.49,20,109,83.18,21,225,0.68,"no men in title"
"803","Trng&Ed Coord",33.69,6,82,33.04,2,84,66.73,8,166,1.02,""
"804","Trng&Ed Coord,Asst",26.79,4,90,49.49,20,109,76.28,24,199,0.54,"no men in title"
"805","Trng&Ed Coord,Asst-BU",26.79,1,119,49.49,20,109,76.28,21,228,0.54,"no men in title"
"806","Trng&Ed Coord,Sr",35.74,7,63,33.73,2,77,69.47,9,140,1.06,""
"807","Truck Drvr",27.58,2,68,27.49,36,108,55.07,38,176,1,""
"808","Truck Drvr,Heavy",29,7,207,28.93,34,104,57.93,41,311,1,""
"809","Usher,Head",20.81,1,97,49.49,20,109,70.3,21,206,0.42,"no men in title"
"810","Util Act Rep I",26.81,24,109,26.92,10,80,53.73,34,189,1,""
"811","Util Act Rep II",29.51,23,109,29.56,3,76,59.07,26,185,1,""
"812","Util Act Rep Supv I",49.65,16,102,31.79,2,20,81.44,18,122,1.56,"no women in title"
"813","Util Act Rep Supv II",36.3,3,107,36.3,2,59,72.6,5,166,1,""
"814","Util Act Rep Trne",21.2,9,5,21.03,7,4,42.23,16,9,1.01,""
"815","Util Acts Supv",31.91,5,56,49.49,20,109,81.4,25,165,0.64,"no men in title"
"816","Util Astnce Supv",33.69,1,12,49.49,20,109,83.18,21,121,0.68,"no men in title"
"817","Util Constr Lead Wkr",49.65,16,102,29,8,26,78.65,24,128,1.71,"no women in title"
"818","Util Constr Wkr",26.33,2,110,26.71,25,55,53.04,27,165,0.99,""
"819","Util Hearing Ofcr",42.25,2,68,49.49,20,109,91.74,22,177,0.85,"no men in title"
"820","Util Laborer",22.56,3,123,22.56,29,116,45.12,32,239,1,""
"821","Util Svc Inspector",34.74,1,179,34.74,3,105,69.48,4,284,1,""
"822","Util Svc Inspector,Sr",37.35,1,98,37.35,2,114,74.7,3,212,1,""
"823","Util Svc Rep",31.25,11,78,32.07,4,98,63.32,15,176,0.97,""
"824","Util Systs Maint Tech",49.65,16,102,27.63,4,52,77.28,20,154,1.8,"no women in title"
"825","Util Systs Maint Tech,Sr",49.65,16,102,29.24,2,52,78.89,18,154,1.7,"no women in title"
"826","Victim Advocate",30.31,14,166,30.55,2,156,60.86,16,322,0.99,""
"827","Victim Advocate Supv",36.3,1,6,49.49,20,109,85.79,21,115,0.73,"no men in title"
"828","Video Spec II",36.3,2,126,35.43,9,80,71.73,11,206,1.02,""
"829","Volunteer Prgms Coord",29.99,4,86,29.99,1,16,59.98,5,102,1,""
"830","Volunteer Supv",26.26,1,63,49.49,20,109,75.75,21,172,0.53,"no men in title"
"831","Warehouse Supv",49.65,16,102,34.94,1,60,84.59,17,162,1.42,"no women in title"
"832","Warehouser,Chief",30.88,2,86,30.88,9,139,61.76,11,225,1,""
"833","Warehouser,Sr",49.65,16,102,26.5,1,176,76.15,17,278,1.87,"no women in title"
"834","Warehouser,Sr-BU",26.42,12,104,26.4,20,119,52.82,32,223,1,""
"835","Warehouser-BU",24.08,4,127,24.08,14,128,48.16,18,255,1,""
"836","Workers' Comp Anlyst",35.26,5,58,49.49,20,109,84.75,25,167,0.71,"no men in title"
"837","Workers' Comp Anlyst,Sr",36.99,1,25,49.49,20,109,86.48,21,134,0.75,"no men in title"
"838","Workers' Comp Spec",28.84,1,18,49.49,20,109,78.33,21,127,0.58,"no men in title"
"839","Workers' Comp Supv",43.1,1,58,49.49,20,109,92.59,21,167,0.87,"no men in title"
"840","Wtr Laboratory Tech",49.65,16,102,24.07,5,121,73.72,21,223,2.06,"no women in title"
"841","Wtr Meter Changer",49.65,16,102,25.28,1,110,74.93,17,212,1.96,"no women in title"
"842","Wtr Meter Repairer",49.65,16,102,26.69,1,100,76.34,17,202,1.86,"no women in title"
"843","Wtr Meter Repairer,Sr",27.67,1,183,27.67,2,146,55.34,3,329,1,""
"844","Wtr Pipe CC",49.65,16,102,38.42,2,158,88.07,18,260,1.29,"no women in title"
"845","Wtr Pipe CC-WDM II",49.65,16,102,38.77,6,71,88.42,22,173,1.28,"no women in title"
"846","Wtr Pipe Wkr",30.18,2,194,30.18,25,96,60.36,27,290,1,""
"847","Wtr Pipe Wkr Sr-WDM II",33.64,4,85,33.64,27,67,67.28,31,152,1,""
"848","Wtr Pipe Wkr,Sr",49.65,16,102,32.37,10,191,82.02,26,293,1.53,"no women in title"
"849","Wtr Pipe Wkr-WDM I",30.46,1,88,29.94,15,25,60.4,16,113,1.02,""
"850","Wtr Quality Anlyst",33.69,3,117,33.69,3,126,67.38,6,243,1,""
"851","Wtr Quality Anlyst,Asst",31.16,2,78,49.49,20,109,80.65,22,187,0.63,"no men in title"
"852","Wtr Quality Anlyst,Sr",36.3,2,126,36.3,1,57,72.6,3,183,1,""
"853","Wtr Quality Anlyst,Supv",39.2,1,90,39.2,1,91,78.4,2,181,1,""
"854","Wtr Quality Engr",44.74,1,171,49.49,20,109,94.23,21,280,0.9,"no men in title"
"855","Wtr Quality Engr,Sr",49.65,16,102,50.69,2,85,100.34,18,187,0.98,"no women in title"
"856","Wtr Syst Op",49.65,16,102,38.58,5,140,88.23,21,242,1.29,"no women in title"
"857","Wtr Syst Op,Sr",41.72,1,150,41.72,1,120,83.44,2,270,1,""
"858","Wtr Systs Supv",49.65,16,102,47.63,2,138,97.28,18,240,1.04,"no women in title"
"859","Wtr Treatment CC",36.3,1,173,36.3,1,164,72.6,2,337,1,""
"860","Wtr Treatment Equip Tech",49.65,16,102,33.09,1,42,82.74,17,144,1.5,"no women in title"
"861","Wtr Treatment Op,Sr",49.65,16,102,31.34,2,96,80.99,18,198,1.58,"no women in title"
"862","Wtr Treatment Op-Asg Relief",49.65,16,102,29.08,1,192,78.73,17,294,1.71,"no women in title"
"863","Wtr Treatment Op-WDM I",28.22,2,88,27.52,3,62,55.74,5,150,1.03,""
"864","Wtrshed Inspector",49.65,16,102,30.81,3,157,80.46,19,259,1.61,"no women in title"
"865","Wtrshed Inspector,Sr",34.94,1,124,49.49,20,109,84.43,21,233,0.71,"no men in title"
"866","Wtrshed Opns Supv",49.65,16,102,39.96,1,107,89.61,17,209,1.24,"no women in title"
"867","Wtrshed Resource Spec",49.65,16,102,36.3,1,170,85.95,17,272,1.37,"no women in title"
"868","Wtrshed Resources Tech",49.65,16,102,34.45,1,73,84.1,17,175,1.44,"no women in title"
"869","Wtrworks Maint Spec,Sr-SMU",49.65,16,102,29.99,2,43,79.64,18,145,1.66,"no women in title"
"870","Wtrworks Maint Spec-SMU",49.65,16,102,27.65,3,47,77.3,19,149,1.8,"no women in title"
"871","Wtrworks Maint Supv",49.65,16,102,35.57,1,14,85.22,17,116,1.4,"no women in title"
"872","Grand Total",35.35,3600,82,39.04,6285,78,74.39,9885,160,0.91,""
